llllllllllllllllllllllllllllllll
lP.............................l
l..............................l
l..............................l
l..............................l
l..............................l
l..............................l
l.....llllllllllll.............l
l..............l...............l
l..............l...............l
l..............l...............l
l..............l...............l
l..............l...............l
l..........llllllllllllllll....l
l..............................l
l...........................llll
l..............................l
l..............................l
l..............................l
l..............................l
l..............................l
l..............................l
l..............................l
llllllllllllllllllllllllllllllll
